####
#  #
#  ###
#*   #
#    #
#   ##
####
; 1
####
#  #
#  ###
#    #
#    #
#???##
####
; WALL 1
####
#  #
#  ###
#    #
#????#
#???##
####
; BOX 1
####
# ?#
#  ###
#    #
#    #
#   ##
####
; GOAL 1
####
#  #
#  ###
#    #
#    #
#???##
####
; PLAYER 1
